٧
ابن جهر	ب	٢٠٤
ابن الحاجب - مهذب الدين أحمد
ابن حامد - العزيز ثم - على
ابن الحديد - أبو الفرج
ابن حزم الاشبيلى	ب	٦٣	٨١
ابن حسان - أبو جعفر أحمد
ابن حسداى - أبو جعفر يوسف بن أحمد
ابن الحصن - شهاب الدين
ابن الحصين - أبو القاسم عمر
ابن حفصون - أحمد بن حكم
ابن الحفيد - أبو محمد عبد الله بن محمد بن عبد الملك
ابن الحلاء المرسى	ب	٨١
ابن حلوان - موفق الدين المنفاخ
ابن حمدان الجرائحى	ب	١٧٩
ابن حمدون - أبو بكر محمد بن عبد الله
ابن حمدون بن عبد الصمد بن على اللقب باابى العبر طرد	١٧٦
ابن حمدون النديم	١٨١
ابن خمويه - أبو الفضل محمد ثم - صدر الدين أبو الحسن ثم - هعماد الدين أبو حفص
ثم - معين الدين أبو عبد الله
ابن حميد	١١٥
ابن حوى - أبو الاصبغ
ابن حياشرف الكتاب	٣٠٢
ابن حيان - أبو الفرج
ابن جيدرة - رضى الدين الرحبى
ابن خدود	ب	٣١
ابن خروف المغربى الشاعر	ب	٢٤٦
ابن الخشاب	ب	٢٠٣*	٢١١	ثم - أبو محمد عبد الله بن أحمد
ابن الخصى	١٨٥
ابن الخضر - مهذب الدين أبو نصر
ابن خطيب الرى - جز الدين أبو عبد الله
ابن خلدون أبو مسلم عمر بن أحمد	ب	٣٩	٤١*

ابن الخشاب	ب	٢٠٣*	٢١١	ثم - أبو محمد عبد الله بن أحمد